10000000100000001000
11111010101110101010
10000010101000101010
10111110101011101010
10100010101010100010
10111010111010111110
10001000000010000010
11101011111110101110
10001000100010100000
13111111101010111011
10000000101010121000
10111110101010101110
10001010001010101000
11101011111010101011
10000010000010101000
10111110111110101110
10100000100000100010
11101011111111111010
10001010000000100010
10111010111110101110
10100010000010001000
10101111111011111011
10100000101010000010
10111110101010111110
10000010101010000010
10111010101011111010
10001010001010001000
11101011111010111110
10001000000010000000
11111111111111111111
