10000000121000001000
10111110101010101010
10000010101010100010
10111110101010111110
10100010101013100010
10101010101010101010
10101000101010101010
11101110101110111010
10001000100010001000
10111011111010101011
10001010001010101000
11101010101010101111
10001000101010100000
10111111101010111110
10000010101010100010
10111010101010101110
10101010001010101000
10101011101010101011
10101000101010001000
10101110111011111110
10000010001000100010
10111111101110101010
10100000001000101000
10101110111011101110
10100010100010001000
10111011101110101111
10101000100010100000
10101110111011111110
10000010000000000000
11111111111111111111
