10001000001000000000
10111010111011101110
10000010001010001000
10111111101010111110
10100000100010000010
10101111111111111010
10100000001000000010
10111010111011111110
10001010001000000010
11101110101111111010
10100010100000100010
10111011111110101111
10100010001000100000
10101110101010111110
10001000101010001000
10111011101011101011
10100000100010001000
10101110111110111110
10100010100000100210
10111110101111101110
10000010100000100010
11111010101111111010
10001000101000000010
10101011111011111110
10101010000010000000
10111010111111101110
10001010100000001010
10101010111110111010
10100010000003100000
11111111111111111111
