11111111111111111111
00010000000000000101
01010111011111110101
01010101000100010101
01110101110101010101
00000000010101010001
01111111010111011101
01210000010001000001
01011111110101011111
01000000010101000001
01111111010101111101
00000001010100010101
11111101010111010101
00010001010101010001
01110111010101011111
01030101010001000001
01011101011101111101
00010001010101000001
01111101010101011101
01000101010001000101
01010101010111110111
01010101010001010001
01010101011101011101
00010001010000010001
11111101010111110111
01000001010100010001
01011111011101011101
00010000010001000001
01110111110111111101
00010000000100000001
