11111111111111111111
00000000000000000001
01111111111111111101
00000100010000010001
01111101010111010101
01000001010100010101
11011111010101110101
00010000000101000101
01111111111101010111
01000100210101010001
01010101110101011101
00010001010001010001
11111111010111010111
00000100010001010001
01110101111101011101
00010100000101010101
01010111110101010101
01010000010101000101
01011111010101111101
01000100000101000001
01110111111101011101
00010000000001010101
11011111111111010101
01010000000000010001
01011111111101110111
01000000000001010001
01111111111111011101
00000000010000010001
01011111110101110111
01000000000100000301
