11111111111111111111
00000001210000000101
01111111011111010101
01000000010000010001
01011111110111111101
01010000000100000001
01010101111111110111
01010100000000010001
01010111111111011101
01010100010000010001
01010101010111110111
00010101010000010101
01110101111111010101
01000100000001010001
01011111111101011111
01010000000001000001
01011101011111011101
01000001010001010001
01111111010101010101
00000001010101010101
11111101110101110101
03000100000101000101
01110111111101011101
01000000000100010001
01111111111111110111
00010000010000010101
01010111010111010101
01010100010001010101
01010101111101010101
01000100000001000001
