10001000000000000010
10101111111011111010
10100013001000001010
10111010101111101010
10001000100000001000
11101111111111111110
10001000000000000010
10111011111111111010
10120010000000000010
10111110111111111110
10000010000010100000
11111011111010101111
10001000001010001000
10101011111010111110
10101000001010000010
10101111101011111010
10100000100010001000
11111110111110101110
10000000000000100010
10111111111110111110
10100000100000100010
10101110111111101010
10000010100000001000
10111110101111111111
10001000100010000000
11101011111011111010
10001000000010001010
10111111111110101110
10000000000000100000
11111111111111111111
