10000012000010001000
10101111111010101010
10100000001000101010
10111110101111101110
10101000101000100010
10101011111010111010
10001000000013001010
11101111111111101010
10001000001000100010
10111011101110111110
10000010001000000000
11111110111011111111
10000010001000000000
11101011101111111110
10001010100010000000
10111010111010111110
10101010001010001000
10101010101010101111
10100000101010101000
10101111111010101010
10101000000010100010
10101011111111111010
10101000000000001010
10111111111111101110
10000000000010001000
10111111111010111011
10100000001010100000
10111011101010111110
10000010001000000000
11111111111111111111
