10100000001000001000
10101011101110101011
10001000100000101000
10111110111111101010
10001000100000101010
10111011101110101110
10100010001000100010
10101110111011111010
10101000001000000000
10101011111011111110
10101010001000100010
11101110101111101010
10001000100000001010
10111011111111111011
10001010001000001000
11101010101010101110
10001010100010101000
10111010111110111010
10001010000010001010
11101011111111101010
10001000001000001010
10101111101011111010
10100000101010001010
10111111101010101011
10300000001000101002
10111111111111101111
10100000100000100010
10101110101110101010
10001000001000001000
11111111111111111111
