10000000000010000000
11111011111011111011
12000010000010001000
11111110111110101110
10001000100000100010
10101011111011111010
10100010001000101000
10111110101110101110
10001000100000100010
11101010111111111010
10001010001000100010
10111011101010101110
10001010100010101000
11101010111110101011
10001010000010100010
10111011101010101110
10001000001010100000
11101111111010111111
10100010001010000000
10111010101011111110
10100010100000001000
10101111111111111010
10100000000000100010
10111111111110101111
10130000000010100000
10101111111010101110
10001000101000101000
10111010101111111010
10000010000000000010
11111111111111111111
